а/ч	ампер-час
АА	анонимные алкоголики
АБС	автоматизированная банковская система
ава	аватар
АВАКС	awacs
АВД	аварийное выключение двигателя
авиа	авиация
авиабензин	авиационный бензин
авиабой	авиационный бой
авиаотряд	авиационный отряд
авиапредприятие	авиационное предприятие
авиаудар	авиационный удар
АВК	аэровокзальный комплекс
АВМ	аналоговая вычислительная машина
АВНОЮ	Антифашистское вече народного освобождения Югославии
АВР	аттестационно-выпускная работа
автобизнес	автомобильный бизнесс
АГВ	автоматический газовый водонагреватель
АГГ	антигемофильный глобулин
агитискусство	агитационное искусство
АГО	автогражданская ответственность
АГП	автомат гашения поля
агропром	агропромышленный комплекс
агрорайон 	сельскохозяйственный район
агроучасток	сельскохозяйственный участок
АГС	альтернативная гражданская служба
АГУ	Абхазский государственный университет
АД	авиадесант
АДА	автоматический дрейфующий аэростат
АДГ	авиационный дозирующий генератор
АДИБ	авиационная дивизия истребителей-бомбардировщиков
АДМ	автодегазационная машина
админздание	административное здание
админресурс	административный ресурс
адмотдел	административный отдел
адмтехперсонал	административно-технический персонал
адмчасть	административная часть
АДТ	аэродинамическая труба
АДФ	аденозиндифосфат
АЕБ	Ассоциация Европейского Бизнеса
АЖ	апелляционное жюри
азик	азербайджанец
АЗК	автозаправочный комплекс
АЗС	автозаправочная станция
АЗУ	автомобильное зарядное устройство
АИК	аппарат искусственного кровообращения
АИР	аппарат исправления речи
АИС	автоматизированная информационная система
АИСТ	агрегат искусственной сушки травы
АИФ	аргументы и факты
АК	автомат Калашникова
АКБ	акционерный коммерческий банк
АКВР	агентство по контролю над вооружениями и разоружению
АКДС	адсорбированный коклюшно-дифтерийно-столбнячный анатоксин
АКМ	автомат Калашникова модернизированный
АКП	автоматическая коробка передач
АКПП	автоматическая коробка переключения передач
АКТГ	адренокортикотропный гормон
АКЦ	Астрокосмический центр
АЛО	астролевитирующий объект
АЛС	автоматическая лунная станция
АЛУ	арифметическое логическое устройство
АМС	автоматическая межпланетная станция
амстафф	американский стаффордширский терьер
АМСУ	администрация местного самоуправления
АМТС	автоматическая междугородная телефонная станция
АМФ	аденозинмонофосфат
АН	академия наук
анал	аналитическая геометрия
АНБ	Агентство национальной безопасности
АНИС	Американский национальный институт стандартов
АНО	автономная некоммерческая организация
АНТК	авиационный научно-технический комплекс 
АО	акционерное общество
АОЗТ	акционерное общество закрытого типа
АОН	автоматический определитель номера
АООТ	акционерное общество открытого типа
АП	Ассошиэйтед пресс
АПГ	авианосная противолодочная группа
АПК	агропромышленный комплекс
АПЛ	атомная подводная лодка
АПН	академия педагогических наук
АР	авиационная разведка
АРБ	Ассоциация российских банков
АРВ	автоматический радиоветромер
АРГ	аварийно-ремонтная группа
АРЗ	авторемонтный завод
АРК	Автоматический радиокомпас
АРМ	автоматизированное рабочее место
АРМС	автоматическая радиометеорологическая станция
АРС	автоматическое регулирование скорости
артбой	артиллерийский бой
артгруппа	артиллерийская группа
артканонада	артиллерийская канонада
артналёт	артиллерийский налёт
артобстрел	артиллерийский обстрел
артподготовка	артиллерийская подготовка
артудар	артиллерийский удар
артучилище	артиллерийское училище
АРУ	автоматическая регулировка усиления
АС	автоматизированная система
АСБО	Африканская сеть бассейновых организаций
АСЕАН	Ассоциация стран Юго-Восточной Азии
АСКП	автоматизированная система контроля пассажиров
АСОЖ	автоматическая система обеспечения жизнедеятельности
АСПО	асфальтосмолопарафиновые отложения
АСПР	автоматизированная система плановых расчётов
АССР	Автономная Советская Социалистическая Республика
АСУ	автоматизированная система управления
АТБ	авиационно-техническая база
АТО	автотормозное оборудование
АТР	Азиатско-Тихоокеанский регион
АТС	автоматическая телефонная станция
АТФ	аденозинтрифосфат (носитель энергии в живом организме)
АТЭС	Азиатско-Тихоокеанское экономическое сотрудничество
АТЭЦ	атомная теплоэлектроцентраль
АУГ	авианесущая ударная группировка
АФАР	активная фазированная антенная решётка
Афган	Афганистан
АФП	Агентство Франс Пресс
АФС	антенно-фидерная система
АХ	Академия художеств
АХО	административно-хозяйственный отдел
АХОВ	аварийно химически опасное вещество
АХОВ ИД	аварийно химически опасное вещество ингаляционного действия
АХОВ КРД	аварийно химически опасное вещество кожно-резорбтивного действия
АХОВ ПД	аварийно химически опасное вещество перорального действия
АХР	административно-хозяйственная работа
АХРР	Ассоциация художников революционной России
АХУ	административно-хозяйственное управление
АХЧ	административно-хозяйственная часть
АЦПУ	алфавитно-цифровое печатающее устройство
АЧС	африканская чума свиней
АЧФ	астрономические часы Федченко
АЧХ	амплитудно-частотная характеристика
АШ	алмазосодержащая шихта
АЯ	аномальное явление
б/к	боекомплект
б/у	бывший в употреблении
БАД	биологически активная добавка
БАК	Большой адронный коллайдер
БАН	Библиотека Академии Наук
БАС	боковой амиотрофический склероз
БАТ	биологически активная точка
БВК	белково-витаминный концентрат
БГТО	Будь готов к труду и обороне
БГУ	Белорусский государственный университет
БДК	большой десантный корабль
БЗН	блоки зажимов наборных
БИН	Ботанический институт им. В. Л. Комарова	
биообъект	биологический обьект
биоробот	биологический робот
БИП	боевой информационный пост
БКЗ	большой концертный зал
БЛУГА	Бугурусланское лётное училище гражданской авиации
БМВ	Баварские моторные заводы
БМД	боевая машина десанта
БМП	боевая машина пехоты
БОВ	боеприпас объёмного взрыва
бомж	малоимущий человек без определённого местожительства и работы
БОФ	безопалубочное формование
БПК	большой противолодочный корабль
БПЛА	беспилотный летательный аппарат
БРАВ	береговые ракетно-артиллерийские войска
БРИКС	Бразилия Россия Индия Китай Южно-Африканская Республика
бронекапсула	броневая капсула
БССР	Белорусская Советская Социалистическая Республика
БТА	большой телескоп альтазимутальный
БТИ	бюро технической инвентаризации
БТК	биткойн
БТР	боевая бронированная машина
БУ	бомбоубежище
БУР	барак усиленного режима
Бутырка	Бутырская тюрьма
БХСС	борьба с хищениями социалистической собственности
БЭР	биологический эквивалент рентгена
БЮТ	блок Юлии Тимошенко
ВАЗ	Волжский автомобильный завод
ВВ	взрывчатые вещества
ВВК	военно-врачебная комиссия
ВВО	Восточный военный округ
ВВП	внутренний валовый продукт
ВВС	военно-воздушные силы
ВВЭР	водо-водяной энергетический реактор
ВДВ	Воздушно-десантные войска
ВДНХ	Выставка достижений народного хозяйства
вещдок	вещественное доказательство
вещмешок	вещевой мешок
ВЗ	Ветхий Завет
вибростойкий	
ВИИ	Военно-инженерный институт
ВИНК	вертикально-интегрированная нефтяная компания
ВИЧ	вирус иммунодефицита человека
ВК	Властелин колец

